
⠀⠀⠀⠀⠀⠀⠀⠀⠀⠀⠀⠀⠀⢀⣀⣤⣤⣤⣀⣀⣀⣀⡀⠀⠀⠀⠀⠀⠀⠀
⠀⠀⠀⠀⠀⠀⠀⠀⠀⠀⠀⢀⣼⠟⠉⠉⠉⠉⠉⠉⠉⠙⠻⢶⣄⠀⠀⠀⠀⠀
⠀⠀⠀⠀⠀⠀⠀⠀⠀⠀⠀⣾⡏⠀⠀⠀⠀⠀⠀⠀⠀⠀⠀⠀⠙⣷⡀⠀⠀⠀
⠀⠀⠀⠀⠀⠀⠀⠀⠀⠀⣸⡟⠀⣠⣶⠛⠛⠛⠛⠛⠛⠳⣦⡀⠀⠘⣿⡄⠀⠀
⠀⠀⠀⠀⠀⠀⠀⠀⠀⢠⣿⠁⠀⢹⣿⣦⣀⣀⣀⣀⣀⣠⣼⡇⠀⠀⠸⣷⠀⠀
⠀⠀⠀⠀⠀⠀⠀⠀⠀⣼⡏⠀⠀⠀⠉⠛⠿⠿⠿⠿⠛⠋⠁⠀⠀⠀⠀⣿⡄⣠
⠀⠀⢀⣀⣀⣀⠀⠀⢠⣿⠀⠀⠀⠀⠀⠀⠀⠀⠀⠀⠀⠀⠀⠀⠀⠀⠀⢻⡇⠀
⠿⠿⠟⠛⠛⠉⠀⠀⣸⡇⠀⠀⠀⠀⠀⠀⠀⠀⠀⠀⠀⠀⠀⠀⠀⠀⠀⢸⡇⠀
⠀⠀⠀⠀⠀⠀⠀⠀⣿⠁⠀⠀⠀⠀⠀⠀⠀⠀⠀⠀⠀⠀⠀⠀⠀⠀⠀⢸⣧⠀
⠀⠀⠀⠀⠀⠀⠀⢸⡿⠀⠀⠀⠀⠀⠀⠀⠀⠀⠀⠀⠀⠀⠀⠀⠀⠀⠀⠈⣿⠀
⠀⠀⠀⠀⠀⠀⠀⣾⡇⠀⠀⠀⠀⠀⠀⠀⠀⠀⠀⠀⠀⠀⠀⠀⠀⠀⠀⠀⣿⠀
⠀⠀⠀⠀⠀⠀⠀⣿⠃⠀⠀⠀⠀⠀⠀⠀⠀⠀⠀⠀⠀⠀⠀⠀⠀⠀⠀⠀⣿⠀
⠀⠀⠀⠀⠀⠀⢰⣿⠀⠀⠀⠀⣠⡶⠶⠿⠿⠿⠿⢷⣦⠀⠀⠀⠀⠀⠀⠀⣿⠀
⠀⠀⣀⣀⣀⠀⣸⡇⠀⠀⠀⠀⣿⡀⠀⠀⠀⠀⠀⠀⣿⡇⠀⠀⠀⠀⠀⠀⣿⠀
⣠⡿⠛⠛⠛⠛⠻⠀⠀⠀⠀⠀⢸⣇⠀⠀⠀⠀⠀⠀⣿⠇⠀⠀⠀⠀⠀⠀⣿⠀
⢻⣇⠀⠀⠀⠀⠀⠀⠀⠀⠀⢀⣼⡟⠀⠀⢀⣤⣤⣴⣿⠀⠀⠀⠀⠀⠀⠀⣿⠀
⠈⠙⢷⣶⣦⣤⣤⣤⣴⣶⣾⠿⠛⠁⢀⣶⡟⠉⠀⠀⠀⠀⠀⠀⠀⠀⠀⢀⡟⠀
⢷⣶⣤⣀⠉⠉⠉⠉⠉⠄⠀⠀⠀⠀⠈⣿⣆⡀⠀⠀⠀⠀⠀⠀⢀⣠⣴⡾⠃⠀
⠀⠈⠉⠛⠿⣶⣦⣄⣀⠀⠀⠀⠀⠀⠀⠈⠛⠻⢿⣿⣾⣿⡿⠿⠟⠋⠁⠀⠀⠀

